1111111111111111111111111111111111111111111111111111111111111111111111111111111111111111111111111111111111111111111
1PC1000000000100000CC001111100010000001C001111100010000001C001111100010000001C001111100010000001C001111100010000001
11C001111100010000001C000000000010000001C001111100010000001C001111100010000001C001111100010000001C00111110001000001
1000011C0000000000001C000000000010000001C001111100010000001C001111100010000001C001111100010000001C00111110001000001
111001111100010000001C000000000010000001C001111100010000001C001111100010000001C001111100010000001C00111110001000001
1ECC1100000001000000C000000000010000001C001111100010000001C001111100010000001C001111100010000001C001111100010000001
1111111111111111111111111111111111111111111111111111111111111111111111111111111111111111111111111111111111111111111